WWWWWWWWWWWWWWWWWWWWWWWWWWWWWWWWWWWWWWWWWWWWWWWWWWWWWwWWWW
W                                                        W
W                                                        W
W     WWWWWWWWW  WWWWWWWWWW    WWWWWW   WWWWW  WWWWWW    W
W                                                        W
W        O                                               W
W                                                        W
W                                                T       W
W                                                        W
W     WWWWWWWW   WWWWWWWWWW    WWWWWW   WWWWW  WWWWWW    W
W                                                        W
W                                                        W
WWWWWWWWWWWWWWWWWWWWWWWWWWWWWWWWWWWWWWWWWWWWWWWWWWWWWWWWWW